{"options":{"width": 11, "height" : 11, "lvl" : 1},"data":[1,1,1,1,1,1,1,1,1,1,1,
0,0,0,0,1,0,0,0,0,0,1,
1,1,1,0,1,0,1,0,1,1,1,
1,0,0,0,0,0,1,0,0,0,1,
1,0,1,0,1,0,1,1,1,1,1,
1,0,1,0,1,0,0,0,0,0,1,
1,1,1,0,1,1,1,0,1,1,1,
1,0,1,0,0,0,1,0,0,0,1,
1,0,1,0,1,0,1,1,1,1,1,
1,0,0,0,1,0,0,0,0,0,0,
1,1,1,1,1,1,1,1,1,1,1
],"entry":{"x":0,"y":1},"exit":{"x":10,"y":9}}